XXXXXXXXXXXXXXXXXXXXXXXXXXXXXXXXXXXXX
X                                   X
X                                   X
X                        HHHH       XXXXXXXX
X         #              HHHH       Z      X
X                        HHHH       XXXXXXXX
X                                   X
X                                   X
X                                   X
X        T        T                 X
X                                OOOX
XXXXXXXXXXXXXXXXXXXXXXXXXXXXXXXXXXXXX